11111111111111111111
10000000000000010001
10000000000011000101
10011111101001111101
1001C00010000100C101
10011110100101011101
10000010100001000001
10000010101001111111
100100000000000000C1
10000000000001111101
1001111100000000E101
10000000000001100101
10011011000000000001
10010001000000000001
10000C00000000000001
10010001000000101111
10011011000000101P01
10000000000000101101
10000000000000100001
11111111111111111111
