11111111
1C0000C1
10000001
10000001
100P0001
11100001
1E1000C1
11111111
