11111111
10001CC1
10E01CC1
10001111
10000001
10000P01
10000001
11111111
