1111111111111111
1C000000000000P1
1011111111111111
101C000000000011
1010111111111011
10101C0000001011
1010101111101011
1010101C00101011
1010101E10101011
1010101110101011
101010000C101011
1010111111101011
10100000000C1011
1011111111111011
1000000000000C11
1111111111111111
